R 1200 800
NO ./north_wall.xpm
WE ./west_wall.xpm
SO ./south_wall.xpm
EA ./east_wall.xpm

S ./sprite.xpm
F 200,200,200
C 200,200,200

1111111111111111111111111111111111
100000000000000000000000000011111
1000000000000000000000N0001111
100000000000000000000000001
100000000000000000000000001
100000000000011111111111111
100000000000000000000000001
100000000000000000000000001 
100000000000000000000000001
100000000000000000000000001 
100000000000000000100000001
1111111111111111111111111111