R 1200 800
NO ./blabla1.x
WE ./blabla2.xpm
SO ./blabla3.xp
EA ./blabla4.xpmb

S ./blabla5.xpm
F 
C 0,255,256

1111111111111111111111111111111111
10N000000000000000000000000011111
100000000000002000000000001111
10020000000000000000000001
100000000000000000000000001
102000000000011111111111111
100000000000000000000000001
100000000200000000000000001 
100000000000000200000000001
100000000000000000000000001 
100000000000000000100000001
1111111111111111111111111111