R 640 480
NO ./blabla1.xpm
WE ./blabla2.xpm
SO ./blabla3.xpm
EA ./blabla4.xpm

S ./blabla5.xpm
F 0,255,255
C 0,255,255

1111111111111
1000000001
1000111111
1000000111
1000000001
1000000001
1000000001
1000000001
1000000001
1111111111