R 3200 2800
NO ./xpm/north_wall.xpm
WE ./xpm/west_wall.xpm
SO ./xpm/south_wall.xpm
EA ./xpm/east_wall.xpm

S ./xpm/sprite.xpm
F 255,0,255
C 255,182,193

1111111111111111111111111111111111
1000000000000000000000000011111
1000000000000000000000001111
100000000000000000000200001
100000000000000000000000001
100020000000011111111111111
100000000000000000000000001
1000N0000000020002000000001 
100000000000000000000000001
100020000000002000000000001 
100000000000000000100000001
1111111111111111111111111111