R 640 480
NO ./blabla1.x
WE ./blabla2.xpm
SO ./blabla3.xp
EA ./blabla4.xpmb

S ./blabla5.xpm
F 
C 0,255,256

11111111111111111
11011100111101111
10001100000001111
10000000100000111
10000000000000001
11110000N00000001
10000020000000001
10000000000110001
11111111111111111
