R 640 480
NO ./blabla1.xpm
WE ./blabla2.xpm
SO ./blabla3.xpm
EA ./blabla4.xpm

S ./blabla5.xpm
F 0,255,255
C 0,255,255

11111111111111111111
10000000011111111111
10001111111111111111
10000001111111111111
10000000000000000001
10000000000000000001
10000000000000000001
10000000000000000001
10000000000000000001
11111111111111111111