R 800 600

NO ./xpm/north_wall.xpm
WE ./xpm/west_wall.xpm
SO ./xpm/south_wall.xpm
EA ./xpm/east_wall.xpm

S ./xpm/sprite.xpm
F 255,182,193
C 255,0,1

111111111111111111111111111
122222222222222222222222221
100000000000000000000000001
100000000000000000000000001
100000000000000000000000001
100000000000000000000000001
100000000000000000000000001
100000000000000000000000001
100000000000000000000000001
100000000000000000000000001
100000000000000000000000001
100000000000N00000000000001
111111111111111111111111111