R 640 480
NO ./blabla1.x
WE ./blabla2.xpm
SO ./blabla3.xp
EA ./blabla4.xpmb

S ./blabla5.xpm
F 
C 0,255,256

1111111111111111111111111111111111
1000000000000000000000S0000011111
10000000000000000000000001111
100000000000000000000000001
100000000000000000000000001
100000000000011111111111111
100000000000000000000000001
100000000000000000000000001 
100000000000000000000000001
100000000000000000000000001 
100000000000000000100000001
1111111111111111111111111111