R 1200 800

NO ./xpm/space2.xpm
WE ./xpm/bg_blu.xpm
SO ./xpm/space.xpm
EA ./xpm/arena.xpm

S ./xpm/circle_weave.xpm
C 20,8,188
F 255   , 182,       193    

11111111111111111111111111111111
1000000000000100000000000011111
10000000000001000000000S00111
102222222220010000000000001
100000000000010002000000001
100000000000010000000000001
100000000000011111100000001
100000000000000000000000001
10000001000000000000000000111111
100200010000000000000000001
100000010000000000000000001
111111111111111111111111111 
111111      111111111111111
111111      1111      11111